авах - взять
аваачих - отнести / уносить
авчрах - принести
авч явах - взять с собой
ажиллах - работать 
айх - бояться 
агнах - охотиться
агшаах - варить рис / сжимать / стягивать
алах - убить
алдах - терять / ронять / упустить
алхах - шагать
алмайрах - быть невнимательным
амлах - обещать
амрах - отдыхать 
амсах - попробовать на вкус
амьдрах - жить
амьсгалах - дышать
анзаарах - заметить
анхаарах - обратить внимание
асгах - лить / проливать
асаах - включить / зажечь
асуух - спросить
аялах - путешествовать
байх - быть
барих - держать / поймать / строить
бахархах - гордиться
баярлах - радоваться / благодарить
бичих - писать
бодох - думать
болгоомжлох - остерегаться / осторожничать
болох - становиться
босох - встать
будах - красить
бууж өгөх - сдаться
буух - слезть
буцах - возвращаться
буцлах - кипятить
бүжиглэх - танцевать
бэлдэх - готовиться
гайхах - удивиться
гарах - выйти
гомдоох - оскорблять / обижать
гуйх - попросить о чем-либо
гуйвах - колебаться / шататься
гуних - печалиться
гүйх - бегать
гүйцээх - завершить / выполнить
гэрлэх - жениться / выйти замуж
даарах - мерзнуть
дагах - следовать за кем-то / за чем-то
давтах - повторять
дасах - привыкнуть к чему-либо
дурлах - любить
дуудах - звонить / звать
дуулах - петь
дуусах - кончаться / завершаться
дуусгах - закончить / завершить
дэлгэх - расстилать / раскрыть
дэвсэх - постелить
дэмжих - поддержать
дээшлэх - подниматься
доошлох - опускаться
жаргах - радоваться / быть счастливым / наслаждаться
жигнэх - готовить на пару
жолоодох - водить
жуумалзах - слегка улыбнуться / сдерживать смех
заах - преподавать / указывать на
загнах - ругать (младшего)
зажлах - жевать
залгах - соединять / связывать / звонить
залуужих - молодеть
залхах - томиться / утомляться / надоедать (о чем-либо)
зарах - продавать / распоряжаться
засах - чинить / ремонтировать
захиалах - заказывать
захих - заказывать
зовох - страдать / мучиться
зогсох - остановиться
зохиох - сочинять / создавать
зохих - соответствовать / подходить
зөвшөөрөх - разрешать
зугаалах - гулять / развлекаться
зурах - рисовать
зуурах - перемешивать
зүүдлэх - сниться / видеть сон
зүүх - носить / привешивать / нацеплять
идэх - кушать
инээх - смеяться
инээмсэглэх - улыбаться
ирэх - приходить
итгэх - верить / доверять
ичих - стесняться / стыдиться / впадать в спячку
магтах - хвалить / восхвалять / превозносить
маллах - пасти скот
мандах - восходить / подниматься
маргах - спорить
мартах - забыть
мэдрэх - чувствовать
мэдэх - знать
мэндлэх - приветствовать
наалдах - приклеиваться / прижиматься
найдах - надеяться
нас барах - умереть, скончаться
нийлэх - объединяться / соединяться
нисэх - летать
нөлөөлөх - влиять
нөхөх - заполнять
нугалах - сгибать / складывать
нүүх - передвигаться
нэмэх - добавить
нээх - открыть
оёх - шить
ойлгох - понимать
олох - найти
онгойлгох - открывать / раскрывать
оролцох - участвовать / вмешиваться
орох - входить / заходить
орчуулах  - переводить (про языки)
очих - идти / ехать / отправляться
өвдөх - болеть / хворать
өвчин тусах - заразиться
өгөх - давать
өлсөх - голодать
өмсөх - одеваться / надеть на себя
өмсөж үзэх - примерить
өнгөрөх - протекать / истекать / миновать
өөрчлөх - менять / преобразовывать
өргөх - поднять
өрөвдөх - сочувствовать / соболезновать
өшиглөх - пинать
сайжрах - улучшаться / совершенствоваться
санаа зовох - беспокоиться
санаа нийлэх - соглашаться
санах - помнить / скучать
согтох - пьянеть
солих - обменивать
сонгох - выбирать / голосовать
сонсох - слушать / услышать
сорох - втягивать / сосать
судлах - исследовать
суллах - освобождать / отпускать / опоржнять
сунгах - растягивать / продлевать
сурах - учиться / обучаться / привыкать
сургах - учить / обучать / преподавать
суух - сидеть
сэлэх - плавать
сэрэх - просыпаться
тааралдах - попадаться / натыкаться
таарах - соответствовать / подходить
тавих - класть / ставить / выпускать
тайлах - снимать / развязывать / разбирать
тайлбарлах - объяснять
танилцах - знакомиться / представляться
таних - узнать / распознать
тасрах - отрываться / прекращаться
татах - тянуть
тоглох - играть
тогтоох - останавливать / выучить
тонших - стучать / клевать
тоолох - считать
төгсөх - завершаться / заканчивать (универ)
төлөх - платить
төрөх - рожать / рождаться
тусах - попадать / падать / капать
туслах - помогать
түгжих - запирать / закрывать
түлхэх - толкать
түрээслэх - арендовать
түүх - собирать
тэврэх - обнимать
тэгэх - делать так / делать таким образом
тэжээх - кормить / выращивать / воспитывать
тэмцэх - бороться
тэнэх - бродить / шататься
угаах - мыть / стирать
удах - длиться / продолжаться / медлить
уйдах - надоедать / наводить скуку
уйлах - плакать
унах - падать / ездить верхом
унтах - спать
унтраах - тушить / гасить / выключать
унших - читать
ургах - расти
урих - приглашать
усанд орох - принимать ванну
услах - поить / поливать
утасдах - звонить / разговаривать по телефону
уулзах - встречаться / видеться
уурлах - сердиться
уусах - растворяться / ассимилироваться
уух - пить
уучлах - прощать
үзэх - смотреть / изучать
үзүүлэх - показывать
үнэрлэх - нюхать
үргэлжлүүлэх - продолжать
үргэлжлэх - продолжаться
үсрэх - прыгать
үхэх - умереть
хаах - закрывать
хагалах - разламывать / раскалывать / разбивать
хавдах - опухать (опухоль, отек)
хайрлах - любить / жалеть
хайх - искать
халууцах - чувствовать жару / страдать от жары
халуурах - температурить / лихорадить
хамаарах - принадлежать / относиться
хамгаалах - защищать
ханиах - кашлять
ханиад хүрэх - простудиться
харагдах - показываться / виднеться
харах - видеть, смотреть / присматривать
хариулах - отвечать
харих - возвращаться / вернуться
хасах - вычитать / уменьшать
хаях - бросать / кидать / выбрасывать
хийх - делать / класть / наливать
хожигдох - проигрывать
хонох - ночевать
хооллох - кушать / питаться
хориглох - запрещать
хоцрох - опаздывать / отставать
хөгшрөх - стареть
хөлдөх - морозить
хөргөх - охлаждать / остужать
хөхрөх - хохотать
хөшиглөх - разделывать мясо
хуваах - делиться
хугалах - ломать
худалдах - продавать
хүлээх - ждать
хүндлэх - уважать / почитать
хүрэх - трогать / добираться
хэвлэх - печатать
хэвтэх - лежать / ложиться
хэлмэгдүүлэх - репрессировать / наносить вред
хэлмэгдэх - подвергаться репресии / терпеть ущерб
хэлэх - сказать / говорить
хэлэлцэх - обсуждать
хэрчих - нарезать (мясо) / крошить
хэрэглэх - применять / использовать
хянах - следить / контролировать
цангах - испытывать жажду
цуглуулах - собирать / коллекционировать
цэвэрлэх - чистить / убирать
цэнэглэх - пополнить / зарядить
цээжлэх - выучить наизусть / запомнить
чадах - мочь / уметь
чагнах - слушать / прислушиваться
чанах - варить
шалгах - проверять
шалтгаалах - зависеть от / служить причиной
шарах - жарить
шидэх - кидать
шийдэх - решать / принимать решение
шийтгэх - наказывать
шүршүүрт орох - принимать душ
эвдрэх - ломаться / выйти из строя
эвдэх - ломать / разбивать / разрушать
эвлэрэх - мириться
эдгэх - выздороветь / поправиться
эдгэрэх - выздоравливать / поравляться
эзлэх - захватывать / оккупировать
элгэх - посылать / отправлять
элдэх - раскатывать (тесто) / мять
элсэх - вступать / поступать
эмчлэх - лечить
эмээх - страшиться / стесняться
эргэх - кружиться / вращаться
эхлэх - начинать / начинаться
ээлжлэх - делать поочередно (вдвоем)
яарах - торопиться
яах - что делать / как быть
явах - ходить / идти / уходить
явуулах - отправлять / посылать
ядрах - уставать / утомляться / обнищать
ярих - разговаривать